NO       ./asset/box_closed.xpm


SO ./asset/fire_ground.xpm
WE       ./asset/box_opened.xpm


EA    ./asset/sword_ground.xpm

F 220,100,0

C 225,30,0

    1111111111111111111111111
    1000000000110000000000001
    1011000001110000000000001
    100100000000000000000000111111111
111111111011000001110000000000001
100000001011000001110111111111111
11110111111111011100000010001
11110111111111011101010010001
11000000110101011100000010001       
10000000010000001100000010001
10000001110000001101010010N01
11000001 1010101111101111000111
11110111 1110101 101111010001 11111111 1111111 111111111111
11111111111111111111111111111 
