NO       ./asset/box_closed.xpm
EA    ./asset/sword_ground.xpm





SO ./asset/fire_ground.xpm
WE       ./asset/box_opened.xpm



F 153,204,153
C 102,102,255











1111111111111111111111111111111
1000000000000000000000000000001
1000000010101010101010000000001
1000000000000000000000000000001
10000000000000000000000000000011
10000000000000E0000000000100000111111
10000000000000000000000000000011
1000000010000010000000011100001
100000010000000000010001 100001
100000000001000000000101 100001
111111111111111111111111 111111
1 1
1 1
1 1
