NO       ./asset/box_closed.xpm


SO ./asset/fire_ground.xpm
WE       ./asset/box_opened.xpm


EA    ./asset/sword_ground.xpm

F 220,100,0

C 225,30,0

1111111111111111111111111111111
1000000000000000000000000000001
1000000010101010101010000000001
1000000000000000000000000000001
1000000000000000000000000000001
10000000000000E0000000000100001
1000000000000000000000000000001
1000000010000010000000000000001
1000000100000000000100000000001
1000000000010000000001000000001
1111111111111111111111111111111
