C 102,102,255


F 10,204,153



NO       ./asset/box_closed.xpm

EA    ./asset/sword_ground.xpm

SO ./asset/fire_ground.xpm

WE       ./asset/dino_green.xpm








1111111111111111111111111111111  11111
1000000000000000000000000000001  10001
1000000010101010101010000000001  10111
1000000000000000000000000000001  10001
10000000000000000000000000000011111101
1000000000000000000000E001000000000001
10000000000000000000000000000011111111
1000000010000010000000011100001
100000010000000000010001 100001
100000000001000000000101 100001
111111111111111011111111 111111
1 1           101
1 111111111111101
1 1           111




