C 214,255,255


F 091,153,255



NO       ./asset/north_texture.xpm

EA    ./asset/east_texture.xpm

SO ./asset/south_texture.xpm
WE       ./asset/west_texture.xpm


    1111111111111111111111
    1000000000000000000001
    1001110000000001110001
    1000000000000000000001
    1111111111101111111111
              101
1111111111111110111111111111111  11111
1000000000000000000000000000001  10001
1000000010101010101010000000001  10111
1000000000000000000011001100001  10001
10000000001100000000000000000011111101
10000000001100000000000N00000000000001
10000000000000000000000001000011111111
1000000010000010000000011100001
100000010000000000010001 100001
100000000001000000000101 100001
111111111111111011111111 111111
1 1           101
1 111111111111101
1 1           111



